HotKeyAdd	Увеличить Радиус/Область дороги слева/Область средней дороги
HotKeyMinus	Уменьшить Радиус/Область дороги слева/Область средней дороги
HotKeyRise	Увеличить Высоту/Область дороги справа/Расстояние между областями
HotKeyLower	Уменьшить Высоту/Область дороги справа/Расстояние между областями
HotKeyBuild	Строить
HotKeyLaterBuild	Позже построить
HotKeyClear	Очистить
ChangeRoundCenter	Теперь можете назначить другой центр.
Radius	Радиус = 
Height	Высота = 
ConstructionFee	Требуется плата для строительства = 
STEP0	Пожалуйста, выберите начальный узел
STEP0ERROR	Этот узел не доступен
3ROUNDSTEP1	Пожалуйста, выберите центр окружности и отрегулируйте радиус = 
YROADSTEP1	Выберите добавленную ширину области дороги слева = 
RightAddedWidth	Добавленная ширина области дороги справа = 
1ROUNDSTEP1	Выберите следующий узел для направления строительства
NOMONEY 	Не хватает денег
3ROUNDSTEP2	Пожалуйста, выберите конечный узел.
YROADSTEP2Single	Пожалуйста, выберите ширину области дороги слева.
YROADSTEP2Dual	Пожалуйста, выберите ширину области средней дороги.
1ROUNDSTEP2	Пожалуйста, выберите конечный узел.
MainRoadWidth	Ширина области средней дороги = 
RightLeftRoadWidth	Ширина областей боковых дорог = 
RoadGaps	Расстояние между областями дорог = 
RightRoadWidth	Ширина области дороги справа = 
LeftRoadWidth	Ширина области дороги слева = 
InvalidShape	Неправильная форма
ShortCut	Горячие клавиши
OtherOption	Дополнительные настройки
NeedMoney	Нужны деньги, чтобы построить дорогу
SMOOTHMODE	(Плавный изгиб дороги)
CurrentRoadWidth	Ширина выбранной дороги = 